....................
....................
.......#####........
..................P.
.....S..............
#####################
