....................
....................
......==.............
....................
..###.....~....^....
....................
..............###....
....................
....................
.............##.......
....................
....................
.............##.......
S......##...##....P.
####################
