....................
.................^..
.......===..........
..................P.
S.............###....
####################
