....................
....................
......==.............
....................
..###.....~....^....
....................
..............###....
....................
....................
.............##.......
...................
....................
...........D........
S....B.##........P.
####################
