..^.......^........^
............^.......
.........#..#.~..P..
....^..=.#..#.#..#..
......~#........^...
......#.^..^.......^
....#......^........
....#...............
.S..................
####################
