....................
....................
....................
......S...###.......
..................P.
#####################
