....................
....................
......==.............
....................
..###.....~....^....
....................
..............###....
....................
....................
....................
....................
....................
....................
S.................P.
####################
