....................
....................
....................
....................
......###=====.......
..................P.
S...................
####################
